9
12
111111111111
011111111111
111110111111
011111111111
111110111111
011111111111
111110111111
011111111111
111111111111

